--------------------------------------------------------------------------------------------------------------------------------------------------------------------------------------------------------------------
--------------------------------------------------------------------------------------------------------------------------------------------------------------------------------------------------------------------
---------------------------------------------S----------------------------------------------------------------------------------------------------------------------------------------------------------------------
--------------------------------------------------------------------------------------------------------------------------------------------------------------------------------------------------------------------
--------------------SSS----SSSS---------------------E--------------------------------------------------------------------------------------------------------------------------E------------------------------------
-------XQQ?QQX--------------------------SSSSSS----QQQQQQQ----------------E-----------------------------------------------SSSSSSS---------------E------E------------------------S--------------------XX--------------
-------X-----X----------------------------------------------------------SSSS----------------------------------------------------------------E----------------------------------------------------E------------------
-------X-----X------X----------------------------------------------------------------------------------------------------------------------------------------------------------?-----------------X------------------
-------XE-E--X------XEE-------X----------------------E--------------X-E--E------------------------------------------------E--E-----------XSSSSSSSSSSSS-----------------E----------------------E--X------------------
-------XQQ-QQX------XSSSSSSSSSX------------------QQQQQQQQ-----------XS?SSSSS---X-----------------------------------------SSSSSSS--------XX-----------------------QQ----X-------E--------------X--X--------------S---
----------------------------------------------------------------------------EE-X--------------------------------Q?QQQ------------------XXX----oooooo-------------------X-------X-----------E--X--X------------------
-------------E---------------------------------------------------X--SSSSSSSSSSSX------------------------------------------------------XXXX-----------------------------X-------X-----------X--X--X------------SS-SS-
-----------------------------------------------------------------X-------------------------------E-E---------------------------------XXXXX----oooooo-------------------X-------X-----------X--X--X--------X---SS-SS-
XXXXXXXXXXXXXXXXXXXXXXXXXXXXXXX----XXX------XXXXXXXXXXXXXXXXXXXXXXXXXXXXXXXXXXXXXXXXXXXXXXXXXXXXXXXXXXXXXXXXXXXXXXXXXXXXXXXXX--XXXXXXXXXXXXXXXXXXXXXXX-----X--XXXXX--XXXXXXXXXXXX-XXXXXXX--X--X--X-----XXXXXXXXXXXXX
