-------------------------------------------------------------------------------------------------------------------------------------------------------------------------------------------------------------------------------------------------------------------------------------------------------------------------
-------------------------------------------------------------------------------------------------------------------------------------------------------------------------------------------------------------------------------------------------------------------------------------------------------------------------
-------------------------------------------------------------------------------------------------------------------------------------------------------------------------------------------------------------------------------------------------------------------------------------------------------------------------
-------------------------------------------------------------------------------------------------------------------------------------------------------------------------------------------------------------------------------------------------------------------------------------------------------------------------
------------------------------------------------------------------------------------------------------------------------------------------------------------------------------------------------------------------------------------------------------------------------------------------------------E------------------
-------------------XXXX----------XXXXXXXXXXXXXXXX--------------------------------------------------------------------------XX--------XXX--------XXXX---------XX----------------------XXXX------------------------------------------------------------------------------------------XX---------E-SSSSS------------------S-
--------------------------------------------------------------------------------------------------------------------------XXX--------XXX--------XXXX---------XX-------------------------------------------------------------------------------------------------------------------XXX------E-----------------------------
-------------------------------------------------------------------------------------------------------------------------XXXX--------XXX--------XXXX---------XX------------------------------------------------------------------------------------------------------------------XXXX------------------------------------
------------------------------------------------------------------------------------------------------------------------XXXXX--------XXX--------XXXX---------XX-----------------------------------------------------------------------------------------------------------------XXXXX---------------------------------S--
-----QQQQ--------------------------------------------------------------------------------------------------------------XXXXXXS-------XXX--------XXXX---------XX--------------------------------------------------------------------ooo-----------------------------------------XXXXXX------------SSS---------------------
-------------------------------------------------------------------B-------------------E------------------------------XXXXXXX--------XXX--------XXXX---------XX----------------------------------------------------------------------------------------------------------------XXXXXX-------------------------------E----
------------------------------------------------------------------Eb-------------------------------------------------XXXXXXXX--------XXX--------XXXX---------XX---------------B---------------------------E--------------------------------------------------------------------XXXXXX----------------------------------E-
-------------------------------------------------------E-----------BEE---------------------------E-EE---------------XXXXXXXXX--------XXX--------XXXX---------XX---------------b------------------------------------------EE-------------------EE-E------------------EE---X-----XXXXXX------------------------------------
XXXXXXXXXXXXXXXXXXXXXXXXX-----XXXXXXXXX--XX--XX--XXXXXXXXXXXXXXXXXXXXXXXXXXXXXXXXXXXXXXXXXXXXXXXXXXXXXXXXXXXXXXXXXXXXXXXXXXXXXX------XXX--------XXXX---------XXXXXXXXX---XXXXXXXXXXXXXXXXXXXXX--XX--XXXXXXXX--XXXXXXXXXXXXXXXXXXXXXXXX--XXXXXXXXXXXXXXXXXXXXXXXXXX--XXXXXX-----XXXXXX----------XXXXXXXXXXXXXXXXXXXXXXXXXX
